1111111111111111111111111111111111
1000000000000000000000000000000001
10000000000000000000000000C0000001
10P0000000000000000000000000111111
11000C0000000000000000000000E00001
1C00000000000000000000000000000001
1111111111111111111111111111111111
