11111111
1000P001
10C00001
100C00E1
11111111
