111111111111111
1P0000000000001
1000000111000C1
1C1111110000001
1000000000000E1
111111111111111
