11111111
10000E01
10C00001
100C00P1
11111111
